##########################################
#                                        #
#                                        #
#                                        #
#                                &       #
#             @                          #
#                                        #
#                                        #
#                                        #
#                                        #
#                                        #
#                            &           #
#      &                                 #
#                                        #
#                                        #
##########################################